My name is - Minun nimeni on
Good day - Hyvää Päivää
Nice to meet you - Hauska tutustua
Salesman - Myyjä
Wrist - Ranne
Strict - Ankara
Team - Joukkue
I am sorry - Olen pahoillani
Eagle - Kotka
Excuse me - Anteeksi
Footrest - Rahi
Twenty - Kaksikymmentä
Talk - Puhua
Construction worker - Rakennusmies
Student - Opiskelija
Cry - Itkeä
Actor - Näyttelijä
Soap - Saippua
Whiteboard - Tussitaulu
Door - Ovi
Translate - Kääntää
Computer - Tietokone
Eraser - Pyyhekumi
Sun - Aurinko
Sponge- Pesusieni
Tree - Puu
Nighttime - Yö
Monday - Maanatai
Mircrowave - Mikroaaltouuni
Bike - Polkupyörä
Onion - Pilkkoa
Foreign exchange - Rahanvaihto
Relaxed - Rentoutunut
Wool - Villa
Shower - Käydä suihkussa
Exercise - Kuntoilu
Teach - Opettaa
T-shirt - T-paita
Suit - Puku
Chess - Shakki
Urinate - Virtsata
Flute - Huilu
Weather - Sää
Toothpick - Hammastikku
School - Koulu
Mushroom - Sieni
Statue - Patsas
Dictionary - Sanakirja
Boar - Villisika
Screwdriver - Ruuvimeisseli
Hill - Kukkula
Change - Vaihtaa
Cherry - Kirsikka
Gold - Kullanvärinen
Cafe - Kahvila
Church - Kirkko
Thursday - Torstai
Embarrassed - Vaivaantunut
Theater - Teatteri
Thick - Tanakka
Police - Poliisi
Clock - Kello
Breakfast - Aamiainen
Study - Opiskella
Wolf - Susi
Spring - Kevät
Buttocks - Takapuoli
Apple - Omena
Mist - Sumua
Artist - Taiteilija
Calm - Tyyni
Finger - Sormi
Child - Lapsi
Deer - Peura
Monkey - Apina
Excited - Innostunut
Bat -Lepakko
Dizzy - Huimaava
Dishwasher - Astianpesukone
Receipt - Kuitti
Passport - Passi
White - Valkoinen
River - Joki
Nice - Mukava
Grandfather - Isoisä
Germany - Saksa
Team - Joukkue
Disagree - Olla eri mieltä
Giraffe - Kirahvi
Birthday - Syntymäpäivä
Read - Lukea
Sheep - Lammas
Ugly - Ruma
Strong - Vahva
Itchy - Syyhy
Lake - Järvi
Music - Musiikki
Economics - Taloustiede
Interview - Haastattelu
Record player - Levysoitin
Rope - Köysi
Telephone - Puhelin
Fox - Ketto
Finals - Loppukilpailu
Neccesary - Välttämätön
Explain - Selittää
Further - Edelleen
Waterfall - Vesiputous
Hair - Hiukset
Bathroom - Kylpyhuone
Sugar - Sokeri
Duck - Ankka
Letter - Kirjain
Winter - Talvi
Push - Työntää
Town - Kaupunki
Popular - Suosittu
Boss - Johtaja
Sandstorm - Hiekkamyrsky
Cat - Kissa
Shark - Hai
Can - Voida
Lawyer - Lakimies
Candy - Karkki
Switch - Kytkin
Scissors - Sakset
Seat - Istumapaikka
Shower - Käydä Suihkuissa
Hole in the ice - Avanto
Monday- Maanantai
Question - Kysymys
Fan - Tuuletin
Speed limit - Nopeusrajoitus
Modern - Nykyaikainen
Performance - Esitys
Chalk - Liitu
Bored - Tylsistynyt
Duty-free - Verovapaa
Headphones - Kuulokkeet
Thing - Asia
Window - Ikkuna
Nedle - Neula
Clothes - Vaatteet
Customer - Asiakas
Asleep - Unessa
Receive - Vastaanottaa
Carrot - Porkkana
Hungry - Nälkäinen
Call - Soittaa
Grape - Viinirypäle
Item - Erä
Pitcher - Kannu
Wireless - Langaton
Possibility - Mahdollisuus
Beaver - Majava
Happiness - Onni
Minimum - Vähimmäismäärä
Refrigerator - Jääkaappi
Blackboard - Liitutaulu
Cat - Kissa
Boat - Vene
Adventure - Seikkailu
Heir - Perillinen
Raincoat - Sadetakki
Curtain - Verho
Fire - Tulipalo
Match - Tulitikku
Boy - Poika
Ceiling - Sisäkatto
Even though - Vaikka
Apricot - Aprikoosi
Explode - Räjähtää
Holiday - Juhlapäivä
Boy - Poika
Negotiation - Neuvottelu
Dictionary - Sanakirja
Persikka - Peach
Scared - Pelästynyt
Translate - Kääntää
Diarrhea - Ripuli
Title - Otsikko
Country - Maa
Difficult - Vaikea
